7 5
1 1 1 1 1
1 5 4 4 1
1 4 2 4 1
1 1 3 1 1
1 4 2 4 1
1 5 4 4 1
1 1 1 1 1